{
    "room_display_id": 7688602,
    "room_real_id": 7688602,
    "type": "STOP_LIVE_ROOM_LIST",
    "data": {
        "cmd": "STOP_LIVE_ROOM_LIST",
        "data": {
            "room_id_list": [
                24196510,
                25885696,
                1077002,
                12546108,
                1788965,
                24159665,
                24675335,
                8103864,
                13803805,
                25566923,
                26286927,
                13320321,
                168988,
                25180663,
                25294434,
                25604762,
                25808369,
                4349292,
                5224052,
                10852876,
                1864795,
                22087395,
                24222440,
                25165685,
                25937606,
                8349836,
                23534665,
                24965286,
                25434175,
                26340725,
                3746196,
                6942110,
                10752198,
                23568662,
                25342730,
                675011,
                6859951,
                9483584,
                12884871,
                22881995,
                24712369,
                354986,
                1927838,
                195909,
                23014322,
                23442711,
                2401568,
                26125169,
                26219159,
                3639573,
                569684,
                9132696,
                26221224,
                26246908,
                3402918,
                10592575,
                2300028,
                23396073,
                23513345,
                21002413,
                232494,
                26170038,
                4458237,
                24437376,
                25920651,
                8261597,
                13787360,
                184786,
                25858584,
                26347038,
                22273654,
                23306280,
                1824455,
                24484430,
                26373278,
                26374837,
                4363174,
                10130309,
                25819560,
                318808,
                23207564,
                26099290,
                4220979,
                458370,
                140650,
                23520222,
                25569116,
                3311827,
                6477657,
                22563950,
                26365980,
                26369540,
                1262181,
                21883017,
                23763286,
                25105875,
                25714426,
                26038710,
                26291876,
                26374889,
                7408377,
                11428075,
                1840199,
                21577710,
                22535535,
                25621870,
                26317064,
                26318564,
                15116785,
                22774610,
                25615873,
                26374840,
                3964784,
                100313,
                12589631,
                14113309,
                26110030,
                603062,
                23565834,
                24769360,
                25063282,
                11690121,
                190333,
                23047365,
                5867669,
                11264563,
                11323095,
                23497106,
                25217700,
                8225502,
                23603136,
                25391036,
                26374757,
                7083316,
                870986,
                26336023,
                2734371,
                21402416,
                4366300
            ]
        }
    }
}